
#
AanI	TTATAA	TTA^_TAA	6
AarI	CACCTGC	CACCTGCNNNN^NNNN_N	7
AasI	GACNNNNNNGTC	GACNN_NN^NNGTC	12
AatII	GACGTC	G_ACGT^C	6
AbaSI	C	CNNNNNNNNN_NN^N	1
AbsI	CCTCGAGG	CC^TCGA_GG	8
Acc16I	TGCGCA	TGC^_GCA	6
Acc36I	ACCTGC	ACCTGCNNNN^NNNN_N	6
Acc65I	GGTACC	G^GTAC_C	6
AccB1I	GGYRCC	G^GYRC_C	6
AccB7I	CCANNNNNTGG	CCAN_NNN^NTGG	11
AccBSI	CCGCTC	CCG^_CTC	6
AccI	GTMKAC	GT^MK_AC	6
AccII	CGCG	CG^_CG	4
AccIII	TCCGGA	T^CCGG_A	6
AciI	CCGC	C^CG_C	4
AclI	AACGTT	AA^CG_TT	6
AclWI	GGATC	GGATCNNNN^N_N	5
AcoI	YGGCCR	Y^GGCC_R	6
AcsI	RAATTY	R^AATT_Y	6
AcuI	CTGAAG	CTGAAGNNNNNNNNNNNNNN_NN^N	6
AcvI	CACGTG	CAC^_GTG	6
AcyI	GRCGYC	GR^CG_YC	6
AdeI	CACNNNGTG	CAC_NNN^GTG	9
AfaI	GTAC	GT^_AC	4
AfeI	AGCGCT	AGC^_GCT	6
AfiI	CCNNNNNNNGG	CCNN_NNN^NNGG	11
AflII	CTTAAG	C^TTAA_G	6
AflIII	ACRYGT	A^CRYG_T	6
AgeI	ACCGGT	A^CCGG_T	6
AgsI	TTSAA	TT_S^AA	5
AhdI	GACNNNNNGTC	GACNN_N^NNGTC	11
AhlI	ACTAGT	A^CTAG_T	6
AjiI	CACGTC	CAC^_GTC	6
AjnI	CCWGG	N^CCWGG_N	5
AjuI	GAANNNNNNNTTGG	cut twice, not yet implemented sorry.	14
AleI	CACNNNNGTG	CACNN^_NNGTG	10
AloI	GAACNNNNNNTCC	cut twice, not yet implemented sorry.	13
AluBI	AGCT	AG^_CT	4
AluI	AGCT	AG^_CT	4
Alw21I	GWGCWC	G_WGCW^C	6
Alw26I	GTCTC	GTCTCN^NNNN_N	5
Alw44I	GTGCAC	G^TGCA_C	6
AlwI	GGATC	GGATCNNNN^N_N	5
AlwNI	CAGNNNCTG	CAG_NNN^CTG	9
Ama87I	CYCGRG	C^YCGR_G	6
Aor13HI	TCCGGA	T^CCGG_A	6
Aor51HI	AGCGCT	AGC^_GCT	6
AoxI	GGCC	N^GGCC_N	4
ApaI	GGGCCC	G_GGCC^C	6
ApaLI	GTGCAC	G^TGCA_C	6
ApeKI	GCWGC	G^CWG_C	5
ApoI	RAATTY	R^AATT_Y	6
ArsI	GACNNNNNNTTYG	cut twice, not yet implemented sorry.	13
AscI	GGCGCGCC	GG^CGCG_CC	8
AseI	ATTAAT	AT^TA_AT	6
AsiGI	ACCGGT	A^CCGG_T	6
AsiSI	GCGATCGC	GCG_AT^CGC	8
Asp700I	GAANNNNTTC	GAANN^_NNTTC	10
Asp718I	GGTACC	G^GTAC_C	6
AspA2I	CCTAGG	C^CTAG_G	6
AspLEI	GCGC	G_CG^C	4
AspS9I	GGNCC	G^GNC_C	5
AsuC2I	CCSGG	CC^S_GG	5
AsuHPI	GGTGA	GGTGANNNNNNN_N^N	5
AsuII	TTCGAA	TT^CG_AA	6
AsuNHI	GCTAGC	G^CTAG_C	6
AvaI	CYCGRG	C^YCGR_G	6
AvaII	GGWCC	G^GWC_C	5
AvrII	CCTAGG	C^CTAG_G	6
AxyI	CCTNAGG	CC^TNA_GG	7

#
BaeGI	GKGCMC	G_KGCM^C	6
BaeI	ACNNNNGTAYC	cut twice, not yet implemented sorry.	11
BalI	TGGCCA	TGG^_CCA	6
BamHI	GGATCC	G^GATC_C	6
BanI	GGYRCC	G^GYRC_C	6
BanII	GRGCYC	G_RGCY^C	6
BarI	GAAGNNNNNNTAC	cut twice, not yet implemented sorry.	13
BauI	CACGAG	C^ACGA_G	6
BbrPI	CACGTG	CAC^_GTG	6
BbsI	GAAGAC	GAAGACNN^NNNN_N	6
Bbv12I	GWGCWC	G_WGCW^C	6
BbvCI	CCTCAGC	CC^TCA_GC	7
BbvI	GCAGC	GCAGCNNNNNNNN^NNNN_N	5
BccI	CCATC	CCATCNNNN^N_N	5
BceAI	ACGGC	ACGGCNNNNNNNNNNNN^NN_N	5
BcgI	CGANNNNNNTGC	cut twice, not yet implemented sorry.	12
BciT130I	CCWGG	CC^W_GG	5
BciVI	GTATCC	GTATCCNNNNN_N^N	6
BclI	TGATCA	T^GATC_A	6
BcnI	CCSGG	CC^S_GG	5
BcoDI	GTCTC	GTCTCN^NNNN_N	5
BcuI	ACTAGT	A^CTAG_T	6
BfaI	CTAG	C^TA_G	4
BfmI	CTRYAG	C^TRYA_G	6
BfoI	RGCGCY	R_GCGC^Y	6
BfrI	CTTAAG	C^TTAA_G	6
BfuAI	ACCTGC	ACCTGCNNNN^NNNN_N	6
BfuI	GTATCC	GTATCCNNNNN_N^N	6
BglI	GCCNNNNNGGC	GCCN_NNN^NGGC	11
BglII	AGATCT	A^GATC_T	6
BisI	GCNGC	GC^N_GC	5
BlnI	CCTAGG	C^CTAG_G	6
BlpI	GCTNAGC	GC^TNA_GC	7
BlsI	GCNGC	GC_N^GC	5
BmcAI	AGTACT	AGT^_ACT	6
Bme1390I	CCNGG	CC^N_GG	5
Bme18I	GGWCC	G^GWC_C	5
BmeRI	GACNNNNNGTC	GACNN_N^NNGTC	11
BmeT110I	CYCGRG	C^YCGR_G	6
BmgBI	CACGTC	CAC^_GTC	6
BmgT120I	GGNCC	G^GNC_C	5
BmiI	GGNNCC	GGN^_NCC	6
BmrFI	CCNGG	CC^N_GG	5
BmrI	ACTGGG	ACTGGGNNNN_N^N	6
BmsI	GCATC	GCATCNNNNN^NNNN_N	5
BmtI	GCTAGC	G_CTAG^C	6
BmuI	ACTGGG	ACTGGGNNNN_N^N	6
BoxI	GACNNNNGTC	GACNN^_NNGTC	10
BpiI	GAAGAC	GAAGACNN^NNNN_N	6
BplI	GAGNNNNNCTC	cut twice, not yet implemented sorry.	11
BpmI	CTGGAG	CTGGAGNNNNNNNNNNNNNN_NN^N	6
Bpu10I	CCTNAGC	CC^TNA_GC	7
Bpu1102I	GCTNAGC	GC^TNA_GC	7
Bpu14I	TTCGAA	TT^CG_AA	6
BpuEI	CTTGAG	CTTGAGNNNNNNNNNNNNNN_NN^N	6
BpuMI	CCSGG	CC^S_GG	5
Bsa29I	ATCGAT	AT^CG_AT	6
BsaAI	YACGTR	YAC^_GTR	6
BsaBI	GATNNNNATC	GATNN^_NNATC	10
BsaHI	GRCGYC	GR^CG_YC	6
BsaI	GGTCTC	GGTCTCN^NNNN_N	6
BsaJI	CCNNGG	C^CNNG_G	6
BsaWI	WCCGGW	W^CCGG_W	6
BsaXI	ACNNNNNCTCC	cut twice, not yet implemented sorry.	11
Bsc4I	CCNNNNNNNGG	CCNN_NNN^NNGG	11
Bse118I	RCCGGY	R^CCGG_Y	6
Bse1I	ACTGG	ACTG_GN^N	5
Bse21I	CCTNAGG	CC^TNA_GG	7
Bse3DI	GCAATG	GCAATG_NN^N	6
Bse8I	GATNNNNATC	GATNN^_NNATC	10
BseAI	TCCGGA	T^CCGG_A	6
BseBI	CCWGG	CC^W_GG	5
BseCI	ATCGAT	AT^CG_AT	6
BseDI	CCNNGG	C^CNNG_G	6
BseGI	GGATG	GGATG_NN^N	5
BseJI	GATNNNNATC	GATNN^_NNATC	10
BseLI	CCNNNNNNNGG	CCNN_NNN^NNGG	11
BseMI	GCAATG	GCAATG_NN^N	6
BseMII	CTCAG	CTCAGNNNNNNNN_NN^N	5
BseNI	ACTGG	ACTG_GN^N	5
BsePI	GCGCGC	G^CGCG_C	6
BseRI	GAGGAG	GAGGAGNNNNNNNN_NN^N	6
BseSI	GKGCMC	G_KGCM^C	6
BseX3I	CGGCCG	C^GGCC_G	6
BseXI	GCAGC	GCAGCNNNNNNNN^NNNN_N	5
BseYI	CCCAGC	C^CCAG_C	6
BsgI	GTGCAG	GTGCAGNNNNNNNNNNNNNN_NN^N	6
Bsh1236I	CGCG	CG^_CG	4
Bsh1285I	CGRYCG	CG_RY^CG	6
BshFI	GGCC	GG^_CC	4
BshNI	GGYRCC	G^GYRC_C	6
BshTI	ACCGGT	A^CCGG_T	6
BshVI	ATCGAT	AT^CG_AT	6
BsiEI	CGRYCG	CG_RY^CG	6
BsiHKAI	GWGCWC	G_WGCW^C	6
BsiHKCI	CYCGRG	C^YCGR_G	6
BsiSI	CCGG	C^CG_G	4
BsiWI	CGTACG	C^GTAC_G	6
BslFI	GGGAC	GGGACNNNNNNNNNN^NNNN_N	5
BslI	CCNNNNNNNGG	CCNN_NNN^NNGG	11
BsmAI	GTCTC	GTCTCN^NNNN_N	5
BsmBI	CGTCTC	CGTCTCN^NNNN_N	6
BsmFI	GGGAC	GGGACNNNNNNNNNN^NNNN_N	5
BsmI	GAATGC	GAATG_CN^N	6
BsnI	GGCC	GG^_CC	4
Bso31I	GGTCTC	GGTCTCN^NNNN_N	6
BsoBI	CYCGRG	C^YCGR_G	6
Bsp119I	TTCGAA	TT^CG_AA	6
Bsp120I	GGGCCC	G^GGCC_C	6
Bsp1286I	GDGCHC	G_DGCH^C	6
Bsp13I	TCCGGA	T^CCGG_A	6
Bsp1407I	TGTACA	T^GTAC_A	6
Bsp143I	GATC	N^GATC_N	4
Bsp1720I	GCTNAGC	GC^TNA_GC	7
Bsp19I	CCATGG	C^CATG_G	6
Bsp68I	TCGCGA	TCG^_CGA	6
BspACI	CCGC	C^CG_C	4
BspANI	GGCC	GG^_CC	4
BspCNI	CTCAG	CTCAGNNNNNNN_NN^N	5
BspDI	ATCGAT	AT^CG_AT	6
BspEI	TCCGGA	T^CCGG_A	6
BspFNI	CGCG	CG^_CG	4
BspHI	TCATGA	T^CATG_A	6
BspLI	GGNNCC	GGN^_NCC	6
BspMAI	CTGCAG	C_TGCA^G	6
BspMI	ACCTGC	ACCTGCNNNN^NNNN_N	6
BspOI	GCTAGC	G_CTAG^C	6
BspPI	GGATC	GGATCNNNN^N_N	5
BspQI	GCTCTTC	GCTCTTCN^NNN_N	7
BspT104I	TTCGAA	TT^CG_AA	6
BspT107I	GGYRCC	G^GYRC_C	6
BspTI	CTTAAG	C^TTAA_G	6
BspTNI	GGTCTC	GGTCTCN^NNNN_N	6
BsrBI	CCGCTC	CCG^_CTC	6
BsrDI	GCAATG	GCAATG_NN^N	6
BsrFI	RCCGGY	R^CCGG_Y	6
BsrGI	TGTACA	T^GTAC_A	6
BsrI	ACTGG	ACTG_GN^N	5
BssAI	RCCGGY	R^CCGG_Y	6
BssECI	CCNNGG	C^CNNG_G	6
BssHII	GCGCGC	G^CGCG_C	6
BssMI	GATC	N^GATC_N	4
BssNAI	GTATAC	GTA^_TAC	6
BssNI	GRCGYC	GR^CG_YC	6
BssSI	CACGAG	C^ACGA_G	6
BssT1I	CCWWGG	C^CWWG_G	6
Bst1107I	GTATAC	GTA^_TAC	6
Bst2BI	CACGAG	C^ACGA_G	6
Bst2UI	CCWGG	CC^W_GG	5
Bst4CI	ACNGT	AC_N^GT	5
Bst6I	CTCTTC	CTCTTCN^NNN_N	6
BstACI	GRCGYC	GR^CG_YC	6
BstAFI	CTTAAG	C^TTAA_G	6
BstAPI	GCANNNNNTGC	GCAN_NNN^NTGC	11
BstAUI	TGTACA	T^GTAC_A	6
BstBAI	YACGTR	YAC^_GTR	6
BstBI	TTCGAA	TT^CG_AA	6
BstC8I	GCNNGC	GCN^_NGC	6
BstDEI	CTNAG	C^TNA_G	5
BstDSI	CCRYGG	C^CRYG_G	6
BstEII	GGTNACC	G^GTNAC_C	7
BstENI	CCTNNNNNAGG	CCTNN^N_NNAGG	11
BstF5I	GGATG	GGATG_NN^N	5
BstFNI	CGCG	CG^_CG	4
BstH2I	RGCGCY	R_GCGC^Y	6
BstHHI	GCGC	G_CG^C	4
BstKTI	GATC	G_AT^C	4
BstMAI	GTCTC	GTCTCN^NNNN_N	5
BstMBI	GATC	N^GATC_N	4
BstMCI	CGRYCG	CG_RY^CG	6
BstMWI	GCNNNNNNNGC	GCNN_NNN^NNGC	11
BstNI	CCWGG	CC^W_GG	5
BstNSI	RCATGY	R_CATG^Y	6
BstPAI	GACNNNNGTC	GACNN^_NNGTC	10
BstPI	GGTNACC	G^GTNAC_C	7
BstSCI	CCNGG	N^CCNGG_N	5
BstSFI	CTRYAG	C^TRYA_G	6
BstSLI	GKGCMC	G_KGCM^C	6
BstSNI	TACGTA	TAC^_GTA	6
BstUI	CGCG	CG^_CG	4
BstV1I	GCAGC	GCAGCNNNNNNNN^NNNN_N	5
BstV2I	GAAGAC	GAAGACNN^NNNN_N	6
BstX2I	RGATCY	R^GATC_Y	6
BstXI	CCANNNNNNTGG	CCAN_NNNN^NTGG	12
BstYI	RGATCY	R^GATC_Y	6
BstZ17I	GTATAC	GTA^_TAC	6
BstZI	CGGCCG	C^GGCC_G	6
Bsu15I	ATCGAT	AT^CG_AT	6
Bsu36I	CCTNAGG	CC^TNA_GG	7
BsuI	GTATCC	GTATCCNNNNN_N^N	6
BsuRI	GGCC	GG^_CC	4
BsuTUI	ATCGAT	AT^CG_AT	6
BtgI	CCRYGG	C^CRYG_G	6
BtgZI	GCGATG	GCGATGNNNNNNNNNN^NNNN_N	6
BtrI	CACGTC	CAC^_GTC	6
BtsCI	GGATG	GGATG_NN^N	5
BtsI	GCAGTG	GCAGTG_NN^N	6
BtsIMutI	CAGTG	CAGTG_NN^N	5
BtuMI	TCGCGA	TCG^_CGA	6
BveI	ACCTGC	ACCTGCNNNN^NNNN_N	6

#
Cac8I	GCNNGC	GCN^_NGC	6
CaiI	CAGNNNCTG	CAG_NNN^CTG	9
CciI	TCATGA	T^CATG_A	6
CciNI	GCGGCCGC	GC^GGCC_GC	8
CfoI	GCGC	G_CG^C	4
Cfr10I	RCCGGY	R^CCGG_Y	6
Cfr13I	GGNCC	G^GNC_C	5
Cfr42I	CCGCGG	CC_GC^GG	6
Cfr9I	CCCGGG	C^CCGG_G	6
ClaI	ATCGAT	AT^CG_AT	6
CpoI	CGGWCCG	CG^GWC_CG	7
CseI	GACGC	GACGCNNNNN^NNNNN_N	5
CsiI	ACCWGGT	A^CCWGG_T	7
Csp6I	GTAC	G^TA_C	4
CspAI	ACCGGT	A^CCGG_T	6
CspCI	CAANNNNNGTGG	cut twice, not yet implemented sorry.	12
CspI	CGGWCCG	CG^GWC_CG	7
CviAII	CATG	C^AT_G	4
CviJI	RGCY	RG^_CY	4
CviKI_1	RGCY	RG^_CY	4
CviQI	GTAC	G^TA_C	4

#
DdeI	CTNAG	C^TNA_G	5
DinI	GGCGCC	GGC^_GCC	6
DpnI	GATC	GA^_TC	4
DpnII	GATC	N^GATC_N	4
DraI	TTTAAA	TTT^_AAA	6
DraIII	CACNNNGTG	CAC_NNN^GTG	9
DrdI	GACNNNNNNGTC	GACNN_NN^NNGTC	12
DriI	GACNNNNNGTC	GACNN_N^NNGTC	11
DseDI	GACNNNNNNGTC	GACNN_NN^NNGTC	12

#
EaeI	YGGCCR	Y^GGCC_R	6
EagI	CGGCCG	C^GGCC_G	6
Eam1104I	CTCTTC	CTCTTCN^NNN_N	6
Eam1105I	GACNNNNNGTC	GACNN_N^NNGTC	11
EarI	CTCTTC	CTCTTCN^NNN_N	6
EciI	GGCGGA	GGCGGANNNNNNNNN_NN^N	6
Ecl136II	GAGCTC	GAG^_CTC	6
EclXI	CGGCCG	C^GGCC_G	6
Eco105I	TACGTA	TAC^_GTA	6
Eco130I	CCWWGG	C^CWWG_G	6
Eco147I	AGGCCT	AGG^_CCT	6
Eco24I	GRGCYC	G_RGCY^C	6
Eco31I	GGTCTC	GGTCTCN^NNNN_N	6
Eco32I	GATATC	GAT^_ATC	6
Eco47I	GGWCC	G^GWC_C	5
Eco47III	AGCGCT	AGC^_GCT	6
Eco52I	CGGCCG	C^GGCC_G	6
Eco53kI	GAGCTC	GAG^_CTC	6
Eco57I	CTGAAG	CTGAAGNNNNNNNNNNNNNN_NN^N	6
Eco72I	CACGTG	CAC^_GTG	6
Eco81I	CCTNAGG	CC^TNA_GG	7
Eco88I	CYCGRG	C^YCGR_G	6
Eco91I	GGTNACC	G^GTNAC_C	7
EcoICRI	GAGCTC	GAG^_CTC	6
EcoNI	CCTNNNNNAGG	CCTNN^N_NNAGG	11
EcoO109I	RGGNCCY	RG^GNC_CY	7
EcoO65I	GGTNACC	G^GTNAC_C	7
EcoRI	GAATTC	G^AATT_C	6
EcoRII	CCWGG	N^CCWGG_N	5
EcoRV	GATATC	GAT^_ATC	6
EcoT14I	CCWWGG	C^CWWG_G	6
EcoT22I	ATGCAT	A_TGCA^T	6
EcoT38I	GRGCYC	G_RGCY^C	6
EgeI	GGCGCC	GGC^_GCC	6
EheI	GGCGCC	GGC^_GCC	6
ErhI	CCWWGG	C^CWWG_G	6
Esp3I	CGTCTC	CGTCTCN^NNNN_N	6

#
FaeI	CATG	_CATG^	4
FaiI	YATR	YA^_TR	4
FalI	AAGNNNNNCTT	cut twice, not yet implemented sorry.	11
FaqI	GGGAC	GGGACNNNNNNNNNN^NNNN_N	5
FatI	CATG	N^CATG_N	4
FauI	CCCGC	CCCGCNNNN^NN_N	5
FauNDI	CATATG	CA^TA_TG	6
FbaI	TGATCA	T^GATC_A	6
FblI	GTMKAC	GT^MK_AC	6
Fnu4HI	GCNGC	GC^N_GC	5
FokI	GGATG	GGATGNNNNNNNNN^NNNN_N	5
FriOI	GRGCYC	G_RGCY^C	6
FseI	GGCCGGCC	GG_CCGG^CC	8
Fsp4HI	GCNGC	GC^N_GC	5
FspAI	RTGCGCAY	RTGC^_GCAY	8
FspBI	CTAG	C^TA_G	4
FspEI	CC	CCNNNNNNNNNNNN^NNNN_N	2
FspI	TGCGCA	TGC^_GCA	6

#
GlaI	GCGC	GC^_GC	4
GluI	GCNGC	GC^N_GC	5
GsaI	CCCAGC	C_CCAG^C	6
GsuI	CTGGAG	CTGGAGNNNNNNNNNNNNNN_NN^N	6

#
HaeII	RGCGCY	R_GCGC^Y	6
HaeIII	GGCC	GG^_CC	4
HapII	CCGG	C^CG_G	4
HgaI	GACGC	GACGCNNNNN^NNNNN_N	5
HhaI	GCGC	G_CG^C	4
Hin1I	GRCGYC	GR^CG_YC	6
Hin1II	CATG	_CATG^	4
Hin6I	GCGC	G^CG_C	4
HinP1I	GCGC	G^CG_C	4
HincII	GTYRAC	GTY^_RAC	6
HindII	GTYRAC	GTY^_RAC	6
HindIII	AAGCTT	A^AGCT_T	6
HinfI	GANTC	G^ANT_C	5
HpaI	GTTAAC	GTT^_AAC	6
HpaII	CCGG	C^CG_G	4
HphI	GGTGA	GGTGANNNNNNN_N^N	5
Hpy166II	GTNNAC	GTN^_NAC	6
Hpy188I	TCNGA	TC_N^GA	5
Hpy188III	TCNNGA	TC^NN_GA	6
Hpy8I	GTNNAC	GTN^_NAC	6
Hpy99I	CGWCG	N_CGWCG^	5
HpyAV	CCTTC	CCTTCNNNNN_N^N	5
HpyCH4III	ACNGT	AC_N^GT	5
HpyCH4IV	ACGT	A^CG_T	4
HpyCH4V	TGCA	TG^_CA	4
HpyF10VI	GCNNNNNNNGC	GCNN_NNN^NNGC	11
HpyF3I	CTNAG	C^TNA_G	5
HpySE526I	ACGT	A^CG_T	4
Hsp92I	GRCGYC	GR^CG_YC	6
Hsp92II	CATG	_CATG^	4
HspAI	GCGC	G^CG_C	4

#
KasI	GGCGCC	G^GCGC_C	6
KflI	GGGWCCC	GG^GWC_CC	7
Kpn2I	TCCGGA	T^CCGG_A	6
KpnI	GGTACC	G_GTAC^C	6
KroI	GCCGGC	G^CCGG_C	6
Ksp22I	TGATCA	T^GATC_A	6
KspAI	GTTAAC	GTT^_AAC	6
KspI	CCGCGG	CC_GC^GG	6
Kzo9I	GATC	N^GATC_N	4

#
LguI	GCTCTTC	GCTCTTCN^NNN_N	7
LmnI	GCTCC	GCTC_CN^N	5
LpnPI	CCDG	CCDGNNNNNNNNNN^NNNN_N	4
Lsp1109I	GCAGC	GCAGCNNNNNNNN^NNNN_N	5
LweI	GCATC	GCATCNNNNN^NNNN_N	5

#
MabI	ACCWGGT	A^CCWGG_T	7
MaeI	CTAG	C^TA_G	4
MaeII	ACGT	A^CG_T	4
MaeIII	GTNAC	N^GTNAC_N	5
MalI	GATC	GA^_TC	4
MauBI	CGCGCGCG	CG^CGCG_CG	8
MbiI	CCGCTC	CCG^_CTC	6
MboI	GATC	N^GATC_N	4
MboII	GAAGA	GAAGANNNNNNN_N^N	5
MfeI	CAATTG	C^AATT_G	6
MflI	RGATCY	R^GATC_Y	6
MhlI	GDGCHC	G_DGCH^C	6
MlsI	TGGCCA	TGG^_CCA	6
MluCI	AATT	N^AATT_N	4
MluI	ACGCGT	A^CGCG_T	6
MluNI	TGGCCA	TGG^_CCA	6
Mly113I	GGCGCC	GG^CG_CC	6
MlyI	GAGTC	GAGTC^_	5
MmeI	TCCRAC	TCCRACNNNNNNNNNNNNNNNNNN_NN^N	6
MnlI	CCTC	CCTCNNNNNN_N^N	4
Mox20I	TGGCCA	TGG^_CCA	6
Mph1103I	ATGCAT	A_TGCA^T	6
MreI	CGCCGGCG	CG^CCGG_CG	8
MroI	TCCGGA	T^CCGG_A	6
MroNI	GCCGGC	G^CCGG_C	6
MroXI	GAANNNNTTC	GAANN^_NNTTC	10
MscI	TGGCCA	TGG^_CCA	6
MseI	TTAA	T^TA_A	4
MslI	CAYNNNNRTG	CAYNN^_NNRTG	10
Msp20I	TGGCCA	TGG^_CCA	6
MspA1I	CMGCKG	CMG^_CKG	6
MspCI	CTTAAG	C^TTAA_G	6
MspI	CCGG	C^CG_G	4
MspJI	CNNR	CNNRNNNNNNNNN^NNNN_N	4
MspR9I	CCNGG	CC^N_GG	5
MssI	GTTTAAAC	GTTT^_AAAC	8
MteI	GCGCNGCGC	GCGC^N_GCGC	9
MunI	CAATTG	C^AATT_G	6
Mva1269I	GAATGC	GAATG_CN^N	6
MvaI	CCWGG	CC^W_GG	5
MvnI	CGCG	CG^_CG	4
MwoI	GCNNNNNNNGC	GCNN_NNN^NNGC	11

#
NaeI	GCCGGC	GCC^_GGC	6
NarI	GGCGCC	GG^CG_CC	6
NciI	CCSGG	CC^S_GG	5
NcoI	CCATGG	C^CATG_G	6
NdeI	CATATG	CA^TA_TG	6
NdeII	GATC	N^GATC_N	4
NgoMIV	GCCGGC	G^CCGG_C	6
NheI	GCTAGC	G^CTAG_C	6
NlaIII	CATG	_CATG^	4
NlaIV	GGNNCC	GGN^_NCC	6
NmeAIII	GCCGAG	GCCGAGNNNNNNNNNNNNNNNNNNN_NN^N	6
NmuCI	GTSAC	N^GTSAC_N	5
NotI	GCGGCCGC	GC^GGCC_GC	8
NruI	TCGCGA	TCG^_CGA	6
NsbI	TGCGCA	TGC^_GCA	6
NsiI	ATGCAT	A_TGCA^T	6
NspI	RCATGY	R_CATG^Y	6
NspV	TTCGAA	TT^CG_AA	6

#
OliI	CACNNNNGTG	CACNN^_NNGTG	10

#
PacI	TTAATTAA	TTA_AT^TAA	8
PaeI	GCATGC	G_CATG^C	6
PaeR7I	CTCGAG	C^TCGA_G	6
PagI	TCATGA	T^CATG_A	6
PalAI	GGCGCGCC	GG^CGCG_CC	8
PasI	CCCWGGG	CC^CWG_GG	7
PauI	GCGCGC	G^CGCG_C	6
PceI	AGGCCT	AGG^_CCT	6
PciI	ACATGT	A^CATG_T	6
PciSI	GCTCTTC	GCTCTTCN^NNN_N	7
PcsI	WCGNNNNNNNCGW	WCGNNN_N^NNNCGW	13
PctI	GAATGC	GAATG_CN^N	6
PdiI	GCCGGC	GCC^_GGC	6
PdmI	GAANNNNTTC	GAANN^_NNTTC	10
PfeI	GAWTC	G^AWT_C	5
Pfl23II	CGTACG	C^GTAC_G	6
PflFI	GACNNNGTC	GACN^N_NGTC	9
PflMI	CCANNNNNTGG	CCAN_NNN^NTGG	11
PfoI	TCCNGGA	T^CCNGG_A	7
PinAI	ACCGGT	A^CCGG_T	6
PkrI	GCNGC	GC_N^GC	5
Ple19I	CGATCG	CG_AT^CG	6
PleI	GAGTC	GAGTCNNNN^N_N	5
PluTI	GGCGCC	G_GCGC^C	6
PmaCI	CACGTG	CAC^_GTG	6
PmeI	GTTTAAAC	GTTT^_AAAC	8
PmlI	CACGTG	CAC^_GTG	6
PpsI	GAGTC	GAGTCNNNN^N_N	5
Ppu21I	YACGTR	YAC^_GTR	6
PpuMI	RGGWCCY	RG^GWC_CY	7
PscI	ACATGT	A^CATG_T	6
PshAI	GACNNNNGTC	GACNN^_NNGTC	10
PshBI	ATTAAT	AT^TA_AT	6
PsiI	TTATAA	TTA^_TAA	6
Psp124BI	GAGCTC	G_AGCT^C	6
Psp1406I	AACGTT	AA^CG_TT	6
Psp5II	RGGWCCY	RG^GWC_CY	7
Psp6I	CCWGG	N^CCWGG_N	5
PspCI	CACGTG	CAC^_GTG	6
PspEI	GGTNACC	G^GTNAC_C	7
PspFI	CCCAGC	C^CCAG_C	6
PspGI	CCWGG	N^CCWGG_N	5
PspLI	CGTACG	C^GTAC_G	6
PspN4I	GGNNCC	GGN^_NCC	6
PspOMI	GGGCCC	G^GGCC_C	6
PspPI	GGNCC	G^GNC_C	5
PspPPI	RGGWCCY	RG^GWC_CY	7
PspXI	VCTCGAGB	VC^TCGA_GB	8
PsrI	GAACNNNNNNTAC	cut twice, not yet implemented sorry.	13
PstI	CTGCAG	C_TGCA^G	6
PstNI	CAGNNNCTG	CAG_NNN^CTG	9
PsuI	RGATCY	R^GATC_Y	6
PsyI	GACNNNGTC	GACN^N_NGTC	9
PteI	GCGCGC	G^CGCG_C	6
PvuI	CGATCG	CG_AT^CG	6
PvuII	CAGCTG	CAG^_CTG	6

#
RgaI	GCGATCGC	GCG_AT^CGC	8
RigI	GGCCGGCC	GG_CCGG^CC	8
RruI	TCGCGA	TCG^_CGA	6
RsaI	GTAC	GT^_AC	4
RsaNI	GTAC	G^TA_C	4
RseI	CAYNNNNRTG	CAYNN^_NNRTG	10
Rsr2I	CGGWCCG	CG^GWC_CG	7
RsrII	CGGWCCG	CG^GWC_CG	7

#
SacI	GAGCTC	G_AGCT^C	6
SacII	CCGCGG	CC_GC^GG	6
SalI	GTCGAC	G^TCGA_C	6
SapI	GCTCTTC	GCTCTTCN^NNN_N	7
SaqAI	TTAA	T^TA_A	4
SatI	GCNGC	GC^N_GC	5
Sau3AI	GATC	N^GATC_N	4
Sau96I	GGNCC	G^GNC_C	5
SbfI	CCTGCAGG	CC_TGCA^GG	8
ScaI	AGTACT	AGT^_ACT	6
SchI	GAGTC	GAGTC^_	5
ScrFI	CCNGG	CC^N_GG	5
SdaI	CCTGCAGG	CC_TGCA^GG	8
SduI	GDGCHC	G_DGCH^C	6
SetI	ASST	N_ASST^	4
SexAI	ACCWGGT	A^CCWGG_T	7
SfaAI	GCGATCGC	GCG_AT^CGC	8
SfaNI	GCATC	GCATCNNNNN^NNNN_N	5
SfcI	CTRYAG	C^TRYA_G	6
SfiI	GGCCNNNNNGGCC	GGCCN_NNN^NGGCC	13
SfoI	GGCGCC	GGC^_GCC	6
Sfr274I	CTCGAG	C^TCGA_G	6
Sfr303I	CCGCGG	CC_GC^GG	6
SfuI	TTCGAA	TT^CG_AA	6
SgeI	CNNG	CNNGNNNNNNNNN^NNNN_N	4
SgfI	GCGATCGC	GCG_AT^CGC	8
SgrAI	CRCCGGYG	CR^CCGG_YG	8
SgrBI	CCGCGG	CC_GC^GG	6
SgrDI	CGTCGACG	CG^TCGA_CG	8
SgsI	GGCGCGCC	GG^CGCG_CC	8
SinI	GGWCC	G^GWC_C	5
SlaI	CTCGAG	C^TCGA_G	6
SmaI	CCCGGG	CCC^_GGG	6
SmiI	ATTTAAAT	ATTT^_AAAT	8
SmiMI	CAYNNNNRTG	CAYNN^_NNRTG	10
SmlI	CTYRAG	C^TYRA_G	6
SmoI	CTYRAG	C^TYRA_G	6
SnaBI	TACGTA	TAC^_GTA	6
SpeI	ACTAGT	A^CTAG_T	6
SphI	GCATGC	G_CATG^C	6
SrfI	GCCCGGGC	GCCC^_GGGC	8
Sse8387I	CCTGCAGG	CC_TGCA^GG	8
Sse9I	AATT	N^AATT_N	4
SseBI	AGGCCT	AGG^_CCT	6
SsiI	CCGC	C^CG_C	4
SspDI	GGCGCC	G^GCGC_C	6
SspI	AATATT	AAT^_ATT	6
SspMI	CTAG	C^TA_G	4
SstI	GAGCTC	G_AGCT^C	6
StuI	AGGCCT	AGG^_CCT	6
StyD4I	CCNGG	N^CCNGG_N	5
StyI	CCWWGG	C^CWWG_G	6
SwaI	ATTTAAAT	ATTT^_AAAT	8

#
TaaI	ACNGT	AC_N^GT	5
TaiI	ACGT	_ACGT^	4
TaqI	TCGA	T^CG_A	4
TaqII	GACCGA	GACCGANNNNNNNNN_NN^N	6
TasI	AATT	N^AATT_N	4
TatI	WGTACW	W^GTAC_W	6
TauI	GCSGC	G_CSG^C	5
TfiI	GAWTC	G^AWT_C	5
Tru1I	TTAA	T^TA_A	4
Tru9I	TTAA	T^TA_A	4
TscAI	CASTG	N_NNCASTGNN^N	5
TseFI	GTSAC	N^GTSAC_N	5
TseI	GCWGC	G^CWG_C	5
Tsp45I	GTSAC	N^GTSAC_N	5
TspDTI	ATGAA	ATGAANNNNNNNNN_NN^N	5
TspGWI	ACGGA	ACGGANNNNNNNNN_NN^N	5
TspMI	CCCGGG	C^CCGG_G	6
TspRI	CASTG	N_NNCASTGNN^N	5
Tth111I	GACNNNGTC	GACN^N_NGTC	9

#
Van91I	CCANNNNNTGG	CCAN_NNN^NTGG	11
Vha464I	CTTAAG	C^TTAA_G	6
VneI	GTGCAC	G^TGCA_C	6
VpaK11BI	GGWCC	G^GWC_C	5
VspI	ATTAAT	AT^TA_AT	6

#
XagI	CCTNNNNNAGG	CCTNN^N_NNAGG	11
XapI	RAATTY	R^AATT_Y	6
XbaI	TCTAGA	T^CTAG_A	6
XceI	RCATGY	R_CATG^Y	6
XcmI	CCANNNNNNNNNTGG	CCANNNN_N^NNNNTGG	15
XhoI	CTCGAG	C^TCGA_G	6
XmaI	CCCGGG	C^CCGG_G	6
XmaJI	CCTAGG	C^CTAG_G	6
XmiI	GTMKAC	GT^MK_AC	6
XmnI	GAANNNNTTC	GAANN^_NNTTC	10
XspI	CTAG	C^TA_G	4

#
ZraI	GACGTC	GAC^_GTC	6
ZrmI	AGTACT	AGT^_ACT	6
Zsp2I	ATGCAT	A_TGCA^T	6
